n: 0
..............
..............
...RRRRRRRRRRR
...R.........R
...R.........R
...R.........R
...R.........R
...RRRRRRRRRRR